AES	SSLError: HTTPSConnectionPool(host='stooq.com', port=443): Max retries exceeded with url: /q/d/l/?s=aes.us&i=d (Caused by SSLError(SSLEOFError(8, '[SSL: UNEXPECTED_EOF_WHILE_READING] EOF occurred in violation of protocol (_ssl.c:1000)')))
ALB	SSLError: HTTPSConnectionPool(host='stooq.com', port=443): Max retries exceeded with url: /q/d/l/?s=alb.us&i=d (Caused by SSLError(SSLEOFError(8, '[SSL: UNEXPECTED_EOF_WHILE_READING] EOF occurred in violation of protocol (_ssl.c:1000)')))
AMCR	SSLError: HTTPSConnectionPool(host='stooq.com', port=443): Max retries exceeded with url: /q/d/l/?s=amcr.us&i=d (Caused by SSLError(SSLEOFError(8, '[SSL: UNEXPECTED_EOF_WHILE_READING] EOF occurred in violation of protocol (_ssl.c:1000)')))
AEP	SSLError: HTTPSConnectionPool(host='stooq.com', port=443): Max retries exceeded with url: /q/d/l/?s=aep.us&i=d (Caused by SSLError(SSLEOFError(8, '[SSL: UNEXPECTED_EOF_WHILE_READING] EOF occurred in violation of protocol (_ssl.c:1000)')))
APP	SSLError: HTTPSConnectionPool(host='stooq.com', port=443): Max retries exceeded with url: /q/d/l/?s=app.us&i=d (Caused by SSLError(SSLEOFError(8, '[SSL: UNEXPECTED_EOF_WHILE_READING] EOF occurred in violation of protocol (_ssl.c:1000)')))
TAP	ConnectionError: HTTPSConnectionPool(host='stooq.com', port=443): Read timed out.
MDLZ	ConnectionError: HTTPSConnectionPool(host='stooq.com', port=443): Max retries exceeded with url: /q/d/l/?s=mdlz.us&i=d (Caused by NameResolutionError("HTTPSConnection(host='stooq.com', port=443): Failed to resolve 'stooq.com' ([Errno 8] nodename nor servname provided, or not known)"))
MPWR	ConnectionError: HTTPSConnectionPool(host='stooq.com', port=443): Max retries exceeded with url: /q/d/l/?s=mpwr.us&i=d (Caused by NameResolutionError("HTTPSConnection(host='stooq.com', port=443): Failed to resolve 'stooq.com' ([Errno 8] nodename nor servname provided, or not known)"))
MNST	ConnectionError: HTTPSConnectionPool(host='stooq.com', port=443): Max retries exceeded with url: /q/d/l/?s=mnst.us&i=d (Caused by NameResolutionError("HTTPSConnection(host='stooq.com', port=443): Failed to resolve 'stooq.com' ([Errno 8] nodename nor servname provided, or not known)"))
MCO	ConnectionError: HTTPSConnectionPool(host='stooq.com', port=443): Max retries exceeded with url: /q/d/l/?s=mco.us&i=d (Caused by NameResolutionError("HTTPSConnection(host='stooq.com', port=443): Failed to resolve 'stooq.com' ([Errno 8] nodename nor servname provided, or not known)"))
MS	ConnectionError: HTTPSConnectionPool(host='stooq.com', port=443): Max retries exceeded with url: /q/d/l/?s=ms.us&i=d (Caused by NameResolutionError("HTTPSConnection(host='stooq.com', port=443): Failed to resolve 'stooq.com' ([Errno 8] nodename nor servname provided, or not known)"))
MOS	ConnectionError: HTTPSConnectionPool(host='stooq.com', port=443): Max retries exceeded with url: /q/d/l/?s=mos.us&i=d (Caused by NameResolutionError("HTTPSConnection(host='stooq.com', port=443): Failed to resolve 'stooq.com' ([Errno 8] nodename nor servname provided, or not known)"))
MSI	ConnectionError: HTTPSConnectionPool(host='stooq.com', port=443): Max retries exceeded with url: /q/d/l/?s=msi.us&i=d (Caused by NameResolutionError("HTTPSConnection(host='stooq.com', port=443): Failed to resolve 'stooq.com' ([Errno 8] nodename nor servname provided, or not known)"))
MSCI	ConnectionError: HTTPSConnectionPool(host='stooq.com', port=443): Max retries exceeded with url: /q/d/l/?s=msci.us&i=d (Caused by NameResolutionError("HTTPSConnection(host='stooq.com', port=443): Failed to resolve 'stooq.com' ([Errno 8] nodename nor servname provided, or not known)"))
NDAQ	ConnectionError: HTTPSConnectionPool(host='stooq.com', port=443): Max retries exceeded with url: /q/d/l/?s=ndaq.us&i=d (Caused by NameResolutionError("HTTPSConnection(host='stooq.com', port=443): Failed to resolve 'stooq.com' ([Errno 8] nodename nor servname provided, or not known)"))
NTAP	ConnectionError: HTTPSConnectionPool(host='stooq.com', port=443): Max retries exceeded with url: /q/d/l/?s=ntap.us&i=d (Caused by NameResolutionError("HTTPSConnection(host='stooq.com', port=443): Failed to resolve 'stooq.com' ([Errno 8] nodename nor servname provided, or not known)"))
NFLX	ConnectionError: HTTPSConnectionPool(host='stooq.com', port=443): Max retries exceeded with url: /q/d/l/?s=nflx.us&i=d (Caused by NameResolutionError("HTTPSConnection(host='stooq.com', port=443): Failed to resolve 'stooq.com' ([Errno 8] nodename nor servname provided, or not known)"))
NEM	ConnectionError: HTTPSConnectionPool(host='stooq.com', port=443): Max retries exceeded with url: /q/d/l/?s=nem.us&i=d (Caused by NameResolutionError("HTTPSConnection(host='stooq.com', port=443): Failed to resolve 'stooq.com' ([Errno 8] nodename nor servname provided, or not known)"))
NWSA	ConnectionError: HTTPSConnectionPool(host='stooq.com', port=443): Max retries exceeded with url: /q/d/l/?s=nwsa.us&i=d (Caused by NameResolutionError("HTTPSConnection(host='stooq.com', port=443): Failed to resolve 'stooq.com' ([Errno 8] nodename nor servname provided, or not known)"))
NWS	ConnectionError: HTTPSConnectionPool(host='stooq.com', port=443): Max retries exceeded with url: /q/d/l/?s=nws.us&i=d (Caused by NameResolutionError("HTTPSConnection(host='stooq.com', port=443): Failed to resolve 'stooq.com' ([Errno 8] nodename nor servname provided, or not known)"))
NEE	ConnectionError: HTTPSConnectionPool(host='stooq.com', port=443): Max retries exceeded with url: /q/d/l/?s=nee.us&i=d (Caused by NameResolutionError("HTTPSConnection(host='stooq.com', port=443): Failed to resolve 'stooq.com' ([Errno 8] nodename nor servname provided, or not known)"))
NKE	ConnectionError: HTTPSConnectionPool(host='stooq.com', port=443): Max retries exceeded with url: /q/d/l/?s=nke.us&i=d (Caused by NameResolutionError("HTTPSConnection(host='stooq.com', port=443): Failed to resolve 'stooq.com' ([Errno 8] nodename nor servname provided, or not known)"))
NI	ConnectionError: HTTPSConnectionPool(host='stooq.com', port=443): Max retries exceeded with url: /q/d/l/?s=ni.us&i=d (Caused by NameResolutionError("HTTPSConnection(host='stooq.com', port=443): Failed to resolve 'stooq.com' ([Errno 8] nodename nor servname provided, or not known)"))
NDSN	ConnectionError: HTTPSConnectionPool(host='stooq.com', port=443): Max retries exceeded with url: /q/d/l/?s=ndsn.us&i=d (Caused by NameResolutionError("HTTPSConnection(host='stooq.com', port=443): Failed to resolve 'stooq.com' ([Errno 8] nodename nor servname provided, or not known)"))
NSC	ConnectionError: HTTPSConnectionPool(host='stooq.com', port=443): Max retries exceeded with url: /q/d/l/?s=nsc.us&i=d (Caused by NameResolutionError("HTTPSConnection(host='stooq.com', port=443): Failed to resolve 'stooq.com' ([Errno 8] nodename nor servname provided, or not known)"))
NTRS	ConnectionError: HTTPSConnectionPool(host='stooq.com', port=443): Max retries exceeded with url: /q/d/l/?s=ntrs.us&i=d (Caused by NameResolutionError("HTTPSConnection(host='stooq.com', port=443): Failed to resolve 'stooq.com' ([Errno 8] nodename nor servname provided, or not known)"))
NOC	ConnectionError: HTTPSConnectionPool(host='stooq.com', port=443): Max retries exceeded with url: /q/d/l/?s=noc.us&i=d (Caused by NameResolutionError("HTTPSConnection(host='stooq.com', port=443): Failed to resolve 'stooq.com' ([Errno 8] nodename nor servname provided, or not known)"))
NCLH	ConnectionError: HTTPSConnectionPool(host='stooq.com', port=443): Max retries exceeded with url: /q/d/l/?s=nclh.us&i=d (Caused by NameResolutionError("HTTPSConnection(host='stooq.com', port=443): Failed to resolve 'stooq.com' ([Errno 8] nodename nor servname provided, or not known)"))
NRG	ConnectionError: HTTPSConnectionPool(host='stooq.com', port=443): Max retries exceeded with url: /q/d/l/?s=nrg.us&i=d (Caused by NameResolutionError("HTTPSConnection(host='stooq.com', port=443): Failed to resolve 'stooq.com' ([Errno 8] nodename nor servname provided, or not known)"))
NUE	ConnectionError: HTTPSConnectionPool(host='stooq.com', port=443): Max retries exceeded with url: /q/d/l/?s=nue.us&i=d (Caused by NameResolutionError("HTTPSConnection(host='stooq.com', port=443): Failed to resolve 'stooq.com' ([Errno 8] nodename nor servname provided, or not known)"))
NVDA	ConnectionError: HTTPSConnectionPool(host='stooq.com', port=443): Max retries exceeded with url: /q/d/l/?s=nvda.us&i=d (Caused by NameResolutionError("HTTPSConnection(host='stooq.com', port=443): Failed to resolve 'stooq.com' ([Errno 8] nodename nor servname provided, or not known)"))
NVR	ConnectionError: HTTPSConnectionPool(host='stooq.com', port=443): Max retries exceeded with url: /q/d/l/?s=nvr.us&i=d (Caused by NameResolutionError("HTTPSConnection(host='stooq.com', port=443): Failed to resolve 'stooq.com' ([Errno 8] nodename nor servname provided, or not known)"))
NXPI	ConnectionError: HTTPSConnectionPool(host='stooq.com', port=443): Max retries exceeded with url: /q/d/l/?s=nxpi.us&i=d (Caused by NameResolutionError("HTTPSConnection(host='stooq.com', port=443): Failed to resolve 'stooq.com' ([Errno 8] nodename nor servname provided, or not known)"))
ORLY	ConnectionError: HTTPSConnectionPool(host='stooq.com', port=443): Max retries exceeded with url: /q/d/l/?s=orly.us&i=d (Caused by NameResolutionError("HTTPSConnection(host='stooq.com', port=443): Failed to resolve 'stooq.com' ([Errno 8] nodename nor servname provided, or not known)"))
OXY	ConnectionError: HTTPSConnectionPool(host='stooq.com', port=443): Max retries exceeded with url: /q/d/l/?s=oxy.us&i=d (Caused by NameResolutionError("HTTPSConnection(host='stooq.com', port=443): Failed to resolve 'stooq.com' ([Errno 8] nodename nor servname provided, or not known)"))
ODFL	ConnectionError: HTTPSConnectionPool(host='stooq.com', port=443): Max retries exceeded with url: /q/d/l/?s=odfl.us&i=d (Caused by NameResolutionError("HTTPSConnection(host='stooq.com', port=443): Failed to resolve 'stooq.com' ([Errno 8] nodename nor servname provided, or not known)"))
OMC	ConnectionError: HTTPSConnectionPool(host='stooq.com', port=443): Max retries exceeded with url: /q/d/l/?s=omc.us&i=d (Caused by NameResolutionError("HTTPSConnection(host='stooq.com', port=443): Failed to resolve 'stooq.com' ([Errno 8] nodename nor servname provided, or not known)"))
ON	ConnectionError: HTTPSConnectionPool(host='stooq.com', port=443): Max retries exceeded with url: /q/d/l/?s=on.us&i=d (Caused by NameResolutionError("HTTPSConnection(host='stooq.com', port=443): Failed to resolve 'stooq.com' ([Errno 8] nodename nor servname provided, or not known)"))
OKE	ConnectionError: HTTPSConnectionPool(host='stooq.com', port=443): Max retries exceeded with url: /q/d/l/?s=oke.us&i=d (Caused by NameResolutionError("HTTPSConnection(host='stooq.com', port=443): Failed to resolve 'stooq.com' ([Errno 8] nodename nor servname provided, or not known)"))
ORCL	ConnectionError: HTTPSConnectionPool(host='stooq.com', port=443): Max retries exceeded with url: /q/d/l/?s=orcl.us&i=d (Caused by NameResolutionError("HTTPSConnection(host='stooq.com', port=443): Failed to resolve 'stooq.com' ([Errno 8] nodename nor servname provided, or not known)"))
OTIS	ConnectionError: HTTPSConnectionPool(host='stooq.com', port=443): Max retries exceeded with url: /q/d/l/?s=otis.us&i=d (Caused by NameResolutionError("HTTPSConnection(host='stooq.com', port=443): Failed to resolve 'stooq.com' ([Errno 8] nodename nor servname provided, or not known)"))
PCAR	ConnectionError: HTTPSConnectionPool(host='stooq.com', port=443): Max retries exceeded with url: /q/d/l/?s=pcar.us&i=d (Caused by NameResolutionError("HTTPSConnection(host='stooq.com', port=443): Failed to resolve 'stooq.com' ([Errno 8] nodename nor servname provided, or not known)"))
PKG	ConnectionError: HTTPSConnectionPool(host='stooq.com', port=443): Max retries exceeded with url: /q/d/l/?s=pkg.us&i=d (Caused by NameResolutionError("HTTPSConnection(host='stooq.com', port=443): Failed to resolve 'stooq.com' ([Errno 8] nodename nor servname provided, or not known)"))
PLTR	ConnectionError: HTTPSConnectionPool(host='stooq.com', port=443): Max retries exceeded with url: /q/d/l/?s=pltr.us&i=d (Caused by NameResolutionError("HTTPSConnection(host='stooq.com', port=443): Failed to resolve 'stooq.com' ([Errno 8] nodename nor servname provided, or not known)"))
PANW	ConnectionError: HTTPSConnectionPool(host='stooq.com', port=443): Max retries exceeded with url: /q/d/l/?s=panw.us&i=d (Caused by NameResolutionError("HTTPSConnection(host='stooq.com', port=443): Failed to resolve 'stooq.com' ([Errno 8] nodename nor servname provided, or not known)"))
PSKY	ConnectionError: HTTPSConnectionPool(host='stooq.com', port=443): Max retries exceeded with url: /q/d/l/?s=psky.us&i=d (Caused by NameResolutionError("HTTPSConnection(host='stooq.com', port=443): Failed to resolve 'stooq.com' ([Errno 8] nodename nor servname provided, or not known)"))
PH	ConnectionError: HTTPSConnectionPool(host='stooq.com', port=443): Max retries exceeded with url: /q/d/l/?s=ph.us&i=d (Caused by NameResolutionError("HTTPSConnection(host='stooq.com', port=443): Failed to resolve 'stooq.com' ([Errno 8] nodename nor servname provided, or not known)"))
PAYX	ConnectionError: HTTPSConnectionPool(host='stooq.com', port=443): Max retries exceeded with url: /q/d/l/?s=payx.us&i=d (Caused by NameResolutionError("HTTPSConnection(host='stooq.com', port=443): Failed to resolve 'stooq.com' ([Errno 8] nodename nor servname provided, or not known)"))
PAYC	ConnectionError: HTTPSConnectionPool(host='stooq.com', port=443): Max retries exceeded with url: /q/d/l/?s=payc.us&i=d (Caused by NameResolutionError("HTTPSConnection(host='stooq.com', port=443): Failed to resolve 'stooq.com' ([Errno 8] nodename nor servname provided, or not known)"))
PYPL	ConnectionError: HTTPSConnectionPool(host='stooq.com', port=443): Max retries exceeded with url: /q/d/l/?s=pypl.us&i=d (Caused by NameResolutionError("HTTPSConnection(host='stooq.com', port=443): Failed to resolve 'stooq.com' ([Errno 8] nodename nor servname provided, or not known)"))
PNR	ConnectionError: HTTPSConnectionPool(host='stooq.com', port=443): Max retries exceeded with url: /q/d/l/?s=pnr.us&i=d (Caused by NameResolutionError("HTTPSConnection(host='stooq.com', port=443): Failed to resolve 'stooq.com' ([Errno 8] nodename nor servname provided, or not known)"))
PEP	ConnectionError: HTTPSConnectionPool(host='stooq.com', port=443): Max retries exceeded with url: /q/d/l/?s=pep.us&i=d (Caused by NameResolutionError("HTTPSConnection(host='stooq.com', port=443): Failed to resolve 'stooq.com' ([Errno 8] nodename nor servname provided, or not known)"))
PFE	ConnectionError: HTTPSConnectionPool(host='stooq.com', port=443): Max retries exceeded with url: /q/d/l/?s=pfe.us&i=d (Caused by NameResolutionError("HTTPSConnection(host='stooq.com', port=443): Failed to resolve 'stooq.com' ([Errno 8] nodename nor servname provided, or not known)"))
PCG	ConnectionError: HTTPSConnectionPool(host='stooq.com', port=443): Max retries exceeded with url: /q/d/l/?s=pcg.us&i=d (Caused by NameResolutionError("HTTPSConnection(host='stooq.com', port=443): Failed to resolve 'stooq.com' ([Errno 8] nodename nor servname provided, or not known)"))
PM	ConnectionError: HTTPSConnectionPool(host='stooq.com', port=443): Max retries exceeded with url: /q/d/l/?s=pm.us&i=d (Caused by NameResolutionError("HTTPSConnection(host='stooq.com', port=443): Failed to resolve 'stooq.com' ([Errno 8] nodename nor servname provided, or not known)"))
PSX	ConnectionError: HTTPSConnectionPool(host='stooq.com', port=443): Max retries exceeded with url: /q/d/l/?s=psx.us&i=d (Caused by NameResolutionError("HTTPSConnection(host='stooq.com', port=443): Failed to resolve 'stooq.com' ([Errno 8] nodename nor servname provided, or not known)"))
PNW	ConnectionError: HTTPSConnectionPool(host='stooq.com', port=443): Max retries exceeded with url: /q/d/l/?s=pnw.us&i=d (Caused by NameResolutionError("HTTPSConnection(host='stooq.com', port=443): Failed to resolve 'stooq.com' ([Errno 8] nodename nor servname provided, or not known)"))
PNC	ConnectionError: HTTPSConnectionPool(host='stooq.com', port=443): Max retries exceeded with url: /q/d/l/?s=pnc.us&i=d (Caused by NameResolutionError("HTTPSConnection(host='stooq.com', port=443): Failed to resolve 'stooq.com' ([Errno 8] nodename nor servname provided, or not known)"))
POOL	ConnectionError: HTTPSConnectionPool(host='stooq.com', port=443): Max retries exceeded with url: /q/d/l/?s=pool.us&i=d (Caused by NameResolutionError("HTTPSConnection(host='stooq.com', port=443): Failed to resolve 'stooq.com' ([Errno 8] nodename nor servname provided, or not known)"))
PPG	ConnectionError: HTTPSConnectionPool(host='stooq.com', port=443): Max retries exceeded with url: /q/d/l/?s=ppg.us&i=d (Caused by NameResolutionError("HTTPSConnection(host='stooq.com', port=443): Failed to resolve 'stooq.com' ([Errno 8] nodename nor servname provided, or not known)"))
PPL	ConnectionError: HTTPSConnectionPool(host='stooq.com', port=443): Max retries exceeded with url: /q/d/l/?s=ppl.us&i=d (Caused by NameResolutionError("HTTPSConnection(host='stooq.com', port=443): Failed to resolve 'stooq.com' ([Errno 8] nodename nor servname provided, or not known)"))
PFG	ConnectionError: HTTPSConnectionPool(host='stooq.com', port=443): Max retries exceeded with url: /q/d/l/?s=pfg.us&i=d (Caused by NameResolutionError("HTTPSConnection(host='stooq.com', port=443): Failed to resolve 'stooq.com' ([Errno 8] nodename nor servname provided, or not known)"))
PG	ConnectionError: HTTPSConnectionPool(host='stooq.com', port=443): Max retries exceeded with url: /q/d/l/?s=pg.us&i=d (Caused by NameResolutionError("HTTPSConnection(host='stooq.com', port=443): Failed to resolve 'stooq.com' ([Errno 8] nodename nor servname provided, or not known)"))
PGR	ConnectionError: HTTPSConnectionPool(host='stooq.com', port=443): Max retries exceeded with url: /q/d/l/?s=pgr.us&i=d (Caused by NameResolutionError("HTTPSConnection(host='stooq.com', port=443): Failed to resolve 'stooq.com' ([Errno 8] nodename nor servname provided, or not known)"))
PLD	ConnectionError: HTTPSConnectionPool(host='stooq.com', port=443): Max retries exceeded with url: /q/d/l/?s=pld.us&i=d (Caused by NameResolutionError("HTTPSConnection(host='stooq.com', port=443): Failed to resolve 'stooq.com' ([Errno 8] nodename nor servname provided, or not known)"))
PRU	ConnectionError: HTTPSConnectionPool(host='stooq.com', port=443): Max retries exceeded with url: /q/d/l/?s=pru.us&i=d (Caused by NameResolutionError("HTTPSConnection(host='stooq.com', port=443): Failed to resolve 'stooq.com' ([Errno 8] nodename nor servname provided, or not known)"))
PEG	ConnectionError: HTTPSConnectionPool(host='stooq.com', port=443): Max retries exceeded with url: /q/d/l/?s=peg.us&i=d (Caused by NameResolutionError("HTTPSConnection(host='stooq.com', port=443): Failed to resolve 'stooq.com' ([Errno 8] nodename nor servname provided, or not known)"))
PTC	ConnectionError: HTTPSConnectionPool(host='stooq.com', port=443): Max retries exceeded with url: /q/d/l/?s=ptc.us&i=d (Caused by NameResolutionError("HTTPSConnection(host='stooq.com', port=443): Failed to resolve 'stooq.com' ([Errno 8] nodename nor servname provided, or not known)"))
PSA	ConnectionError: HTTPSConnectionPool(host='stooq.com', port=443): Max retries exceeded with url: /q/d/l/?s=psa.us&i=d (Caused by NameResolutionError("HTTPSConnection(host='stooq.com', port=443): Failed to resolve 'stooq.com' ([Errno 8] nodename nor servname provided, or not known)"))
PHM	ConnectionError: HTTPSConnectionPool(host='stooq.com', port=443): Max retries exceeded with url: /q/d/l/?s=phm.us&i=d (Caused by NameResolutionError("HTTPSConnection(host='stooq.com', port=443): Failed to resolve 'stooq.com' ([Errno 8] nodename nor servname provided, or not known)"))
PWR	ConnectionError: HTTPSConnectionPool(host='stooq.com', port=443): Max retries exceeded with url: /q/d/l/?s=pwr.us&i=d (Caused by NameResolutionError("HTTPSConnection(host='stooq.com', port=443): Failed to resolve 'stooq.com' ([Errno 8] nodename nor servname provided, or not known)"))
QCOM	ConnectionError: HTTPSConnectionPool(host='stooq.com', port=443): Max retries exceeded with url: /q/d/l/?s=qcom.us&i=d (Caused by NameResolutionError("HTTPSConnection(host='stooq.com', port=443): Failed to resolve 'stooq.com' ([Errno 8] nodename nor servname provided, or not known)"))
DGX	ConnectionError: HTTPSConnectionPool(host='stooq.com', port=443): Max retries exceeded with url: /q/d/l/?s=dgx.us&i=d (Caused by NameResolutionError("HTTPSConnection(host='stooq.com', port=443): Failed to resolve 'stooq.com' ([Errno 8] nodename nor servname provided, or not known)"))
Q	ConnectionError: HTTPSConnectionPool(host='stooq.com', port=443): Max retries exceeded with url: /q/d/l/?s=q.us&i=d (Caused by NameResolutionError("HTTPSConnection(host='stooq.com', port=443): Failed to resolve 'stooq.com' ([Errno 8] nodename nor servname provided, or not known)"))
RL	ConnectionError: HTTPSConnectionPool(host='stooq.com', port=443): Max retries exceeded with url: /q/d/l/?s=rl.us&i=d (Caused by NameResolutionError("HTTPSConnection(host='stooq.com', port=443): Failed to resolve 'stooq.com' ([Errno 8] nodename nor servname provided, or not known)"))
RJF	ConnectionError: HTTPSConnectionPool(host='stooq.com', port=443): Max retries exceeded with url: /q/d/l/?s=rjf.us&i=d (Caused by NameResolutionError("HTTPSConnection(host='stooq.com', port=443): Failed to resolve 'stooq.com' ([Errno 8] nodename nor servname provided, or not known)"))
RTX	ConnectionError: HTTPSConnectionPool(host='stooq.com', port=443): Max retries exceeded with url: /q/d/l/?s=rtx.us&i=d (Caused by NameResolutionError("HTTPSConnection(host='stooq.com', port=443): Failed to resolve 'stooq.com' ([Errno 8] nodename nor servname provided, or not known)"))
O	ConnectionError: HTTPSConnectionPool(host='stooq.com', port=443): Max retries exceeded with url: /q/d/l/?s=o.us&i=d (Caused by NameResolutionError("HTTPSConnection(host='stooq.com', port=443): Failed to resolve 'stooq.com' ([Errno 8] nodename nor servname provided, or not known)"))
REG	ConnectionError: HTTPSConnectionPool(host='stooq.com', port=443): Max retries exceeded with url: /q/d/l/?s=reg.us&i=d (Caused by NameResolutionError("HTTPSConnection(host='stooq.com', port=443): Failed to resolve 'stooq.com' ([Errno 8] nodename nor servname provided, or not known)"))
REGN	ConnectionError: HTTPSConnectionPool(host='stooq.com', port=443): Max retries exceeded with url: /q/d/l/?s=regn.us&i=d (Caused by NameResolutionError("HTTPSConnection(host='stooq.com', port=443): Failed to resolve 'stooq.com' ([Errno 8] nodename nor servname provided, or not known)"))
RF	ConnectionError: HTTPSConnectionPool(host='stooq.com', port=443): Max retries exceeded with url: /q/d/l/?s=rf.us&i=d (Caused by NameResolutionError("HTTPSConnection(host='stooq.com', port=443): Failed to resolve 'stooq.com' ([Errno 8] nodename nor servname provided, or not known)"))
RSG	ConnectionError: HTTPSConnectionPool(host='stooq.com', port=443): Max retries exceeded with url: /q/d/l/?s=rsg.us&i=d (Caused by NameResolutionError("HTTPSConnection(host='stooq.com', port=443): Failed to resolve 'stooq.com' ([Errno 8] nodename nor servname provided, or not known)"))
RMD	ConnectionError: HTTPSConnectionPool(host='stooq.com', port=443): Max retries exceeded with url: /q/d/l/?s=rmd.us&i=d (Caused by NameResolutionError("HTTPSConnection(host='stooq.com', port=443): Failed to resolve 'stooq.com' ([Errno 8] nodename nor servname provided, or not known)"))
RVTY	ConnectionError: HTTPSConnectionPool(host='stooq.com', port=443): Max retries exceeded with url: /q/d/l/?s=rvty.us&i=d (Caused by NameResolutionError("HTTPSConnection(host='stooq.com', port=443): Failed to resolve 'stooq.com' ([Errno 8] nodename nor servname provided, or not known)"))
HOOD	ConnectionError: HTTPSConnectionPool(host='stooq.com', port=443): Max retries exceeded with url: /q/d/l/?s=hood.us&i=d (Caused by NameResolutionError("HTTPSConnection(host='stooq.com', port=443): Failed to resolve 'stooq.com' ([Errno 8] nodename nor servname provided, or not known)"))
ROK	ConnectionError: HTTPSConnectionPool(host='stooq.com', port=443): Max retries exceeded with url: /q/d/l/?s=rok.us&i=d (Caused by NameResolutionError("HTTPSConnection(host='stooq.com', port=443): Failed to resolve 'stooq.com' ([Errno 8] nodename nor servname provided, or not known)"))
ROL	ConnectionError: HTTPSConnectionPool(host='stooq.com', port=443): Max retries exceeded with url: /q/d/l/?s=rol.us&i=d (Caused by NameResolutionError("HTTPSConnection(host='stooq.com', port=443): Failed to resolve 'stooq.com' ([Errno 8] nodename nor servname provided, or not known)"))
ROP	ConnectionError: HTTPSConnectionPool(host='stooq.com', port=443): Max retries exceeded with url: /q/d/l/?s=rop.us&i=d (Caused by NameResolutionError("HTTPSConnection(host='stooq.com', port=443): Failed to resolve 'stooq.com' ([Errno 8] nodename nor servname provided, or not known)"))
ROST	ConnectionError: HTTPSConnectionPool(host='stooq.com', port=443): Max retries exceeded with url: /q/d/l/?s=rost.us&i=d (Caused by NameResolutionError("HTTPSConnection(host='stooq.com', port=443): Failed to resolve 'stooq.com' ([Errno 8] nodename nor servname provided, or not known)"))
RCL	ConnectionError: HTTPSConnectionPool(host='stooq.com', port=443): Max retries exceeded with url: /q/d/l/?s=rcl.us&i=d (Caused by NameResolutionError("HTTPSConnection(host='stooq.com', port=443): Failed to resolve 'stooq.com' ([Errno 8] nodename nor servname provided, or not known)"))
SPGI	ConnectionError: HTTPSConnectionPool(host='stooq.com', port=443): Max retries exceeded with url: /q/d/l/?s=spgi.us&i=d (Caused by NameResolutionError("HTTPSConnection(host='stooq.com', port=443): Failed to resolve 'stooq.com' ([Errno 8] nodename nor servname provided, or not known)"))
CRM	ConnectionError: HTTPSConnectionPool(host='stooq.com', port=443): Max retries exceeded with url: /q/d/l/?s=crm.us&i=d (Caused by NameResolutionError("HTTPSConnection(host='stooq.com', port=443): Failed to resolve 'stooq.com' ([Errno 8] nodename nor servname provided, or not known)"))
SNDK	ConnectionError: HTTPSConnectionPool(host='stooq.com', port=443): Max retries exceeded with url: /q/d/l/?s=sndk.us&i=d (Caused by NameResolutionError("HTTPSConnection(host='stooq.com', port=443): Failed to resolve 'stooq.com' ([Errno 8] nodename nor servname provided, or not known)"))
SBAC	ConnectionError: HTTPSConnectionPool(host='stooq.com', port=443): Max retries exceeded with url: /q/d/l/?s=sbac.us&i=d (Caused by NameResolutionError("HTTPSConnection(host='stooq.com', port=443): Failed to resolve 'stooq.com' ([Errno 8] nodename nor servname provided, or not known)"))
SLB	ConnectionError: HTTPSConnectionPool(host='stooq.com', port=443): Max retries exceeded with url: /q/d/l/?s=slb.us&i=d (Caused by NameResolutionError("HTTPSConnection(host='stooq.com', port=443): Failed to resolve 'stooq.com' ([Errno 8] nodename nor servname provided, or not known)"))
STX	ConnectionError: HTTPSConnectionPool(host='stooq.com', port=443): Max retries exceeded with url: /q/d/l/?s=stx.us&i=d (Caused by NameResolutionError("HTTPSConnection(host='stooq.com', port=443): Failed to resolve 'stooq.com' ([Errno 8] nodename nor servname provided, or not known)"))
SRE	ConnectionError: HTTPSConnectionPool(host='stooq.com', port=443): Max retries exceeded with url: /q/d/l/?s=sre.us&i=d (Caused by NameResolutionError("HTTPSConnection(host='stooq.com', port=443): Failed to resolve 'stooq.com' ([Errno 8] nodename nor servname provided, or not known)"))
NOW	ConnectionError: HTTPSConnectionPool(host='stooq.com', port=443): Max retries exceeded with url: /q/d/l/?s=now.us&i=d (Caused by NameResolutionError("HTTPSConnection(host='stooq.com', port=443): Failed to resolve 'stooq.com' ([Errno 8] nodename nor servname provided, or not known)"))
SHW	ConnectionError: HTTPSConnectionPool(host='stooq.com', port=443): Max retries exceeded with url: /q/d/l/?s=shw.us&i=d (Caused by NameResolutionError("HTTPSConnection(host='stooq.com', port=443): Failed to resolve 'stooq.com' ([Errno 8] nodename nor servname provided, or not known)"))
SPG	ConnectionError: HTTPSConnectionPool(host='stooq.com', port=443): Max retries exceeded with url: /q/d/l/?s=spg.us&i=d (Caused by NameResolutionError("HTTPSConnection(host='stooq.com', port=443): Failed to resolve 'stooq.com' ([Errno 8] nodename nor servname provided, or not known)"))
SWKS	ConnectionError: HTTPSConnectionPool(host='stooq.com', port=443): Max retries exceeded with url: /q/d/l/?s=swks.us&i=d (Caused by NameResolutionError("HTTPSConnection(host='stooq.com', port=443): Failed to resolve 'stooq.com' ([Errno 8] nodename nor servname provided, or not known)"))
SJM	ConnectionError: HTTPSConnectionPool(host='stooq.com', port=443): Max retries exceeded with url: /q/d/l/?s=sjm.us&i=d (Caused by NameResolutionError("HTTPSConnection(host='stooq.com', port=443): Failed to resolve 'stooq.com' ([Errno 8] nodename nor servname provided, or not known)"))
SW	ConnectionError: HTTPSConnectionPool(host='stooq.com', port=443): Max retries exceeded with url: /q/d/l/?s=sw.us&i=d (Caused by NameResolutionError("HTTPSConnection(host='stooq.com', port=443): Failed to resolve 'stooq.com' ([Errno 8] nodename nor servname provided, or not known)"))
SNA	ConnectionError: HTTPSConnectionPool(host='stooq.com', port=443): Max retries exceeded with url: /q/d/l/?s=sna.us&i=d (Caused by NameResolutionError("HTTPSConnection(host='stooq.com', port=443): Failed to resolve 'stooq.com' ([Errno 8] nodename nor servname provided, or not known)"))
SOLS	ConnectionError: HTTPSConnectionPool(host='stooq.com', port=443): Max retries exceeded with url: /q/d/l/?s=sols.us&i=d (Caused by NameResolutionError("HTTPSConnection(host='stooq.com', port=443): Failed to resolve 'stooq.com' ([Errno 8] nodename nor servname provided, or not known)"))
SOLV	ConnectionError: HTTPSConnectionPool(host='stooq.com', port=443): Max retries exceeded with url: /q/d/l/?s=solv.us&i=d (Caused by NameResolutionError("HTTPSConnection(host='stooq.com', port=443): Failed to resolve 'stooq.com' ([Errno 8] nodename nor servname provided, or not known)"))
SO	ConnectionError: HTTPSConnectionPool(host='stooq.com', port=443): Max retries exceeded with url: /q/d/l/?s=so.us&i=d (Caused by NameResolutionError("HTTPSConnection(host='stooq.com', port=443): Failed to resolve 'stooq.com' ([Errno 8] nodename nor servname provided, or not known)"))
LUV	ConnectionError: HTTPSConnectionPool(host='stooq.com', port=443): Max retries exceeded with url: /q/d/l/?s=luv.us&i=d (Caused by NameResolutionError("HTTPSConnection(host='stooq.com', port=443): Failed to resolve 'stooq.com' ([Errno 8] nodename nor servname provided, or not known)"))
SWK	ConnectionError: HTTPSConnectionPool(host='stooq.com', port=443): Max retries exceeded with url: /q/d/l/?s=swk.us&i=d (Caused by NameResolutionError("HTTPSConnection(host='stooq.com', port=443): Failed to resolve 'stooq.com' ([Errno 8] nodename nor servname provided, or not known)"))
SBUX	ConnectionError: HTTPSConnectionPool(host='stooq.com', port=443): Max retries exceeded with url: /q/d/l/?s=sbux.us&i=d (Caused by NameResolutionError("HTTPSConnection(host='stooq.com', port=443): Failed to resolve 'stooq.com' ([Errno 8] nodename nor servname provided, or not known)"))
STT	ConnectionError: HTTPSConnectionPool(host='stooq.com', port=443): Max retries exceeded with url: /q/d/l/?s=stt.us&i=d (Caused by NameResolutionError("HTTPSConnection(host='stooq.com', port=443): Failed to resolve 'stooq.com' ([Errno 8] nodename nor servname provided, or not known)"))
STLD	ConnectionError: HTTPSConnectionPool(host='stooq.com', port=443): Max retries exceeded with url: /q/d/l/?s=stld.us&i=d (Caused by NameResolutionError("HTTPSConnection(host='stooq.com', port=443): Failed to resolve 'stooq.com' ([Errno 8] nodename nor servname provided, or not known)"))
STE	ConnectionError: HTTPSConnectionPool(host='stooq.com', port=443): Max retries exceeded with url: /q/d/l/?s=ste.us&i=d (Caused by NameResolutionError("HTTPSConnection(host='stooq.com', port=443): Failed to resolve 'stooq.com' ([Errno 8] nodename nor servname provided, or not known)"))
SYK	ConnectionError: HTTPSConnectionPool(host='stooq.com', port=443): Max retries exceeded with url: /q/d/l/?s=syk.us&i=d (Caused by NameResolutionError("HTTPSConnection(host='stooq.com', port=443): Failed to resolve 'stooq.com' ([Errno 8] nodename nor servname provided, or not known)"))
SMCI	ConnectionError: HTTPSConnectionPool(host='stooq.com', port=443): Max retries exceeded with url: /q/d/l/?s=smci.us&i=d (Caused by NameResolutionError("HTTPSConnection(host='stooq.com', port=443): Failed to resolve 'stooq.com' ([Errno 8] nodename nor servname provided, or not known)"))
SYF	ConnectionError: HTTPSConnectionPool(host='stooq.com', port=443): Max retries exceeded with url: /q/d/l/?s=syf.us&i=d (Caused by NameResolutionError("HTTPSConnection(host='stooq.com', port=443): Failed to resolve 'stooq.com' ([Errno 8] nodename nor servname provided, or not known)"))
SNPS	ConnectionError: HTTPSConnectionPool(host='stooq.com', port=443): Max retries exceeded with url: /q/d/l/?s=snps.us&i=d (Caused by NameResolutionError("HTTPSConnection(host='stooq.com', port=443): Failed to resolve 'stooq.com' ([Errno 8] nodename nor servname provided, or not known)"))
SYY	ConnectionError: HTTPSConnectionPool(host='stooq.com', port=443): Max retries exceeded with url: /q/d/l/?s=syy.us&i=d (Caused by NameResolutionError("HTTPSConnection(host='stooq.com', port=443): Failed to resolve 'stooq.com' ([Errno 8] nodename nor servname provided, or not known)"))
TMUS	ConnectionError: HTTPSConnectionPool(host='stooq.com', port=443): Max retries exceeded with url: /q/d/l/?s=tmus.us&i=d (Caused by NameResolutionError("HTTPSConnection(host='stooq.com', port=443): Failed to resolve 'stooq.com' ([Errno 8] nodename nor servname provided, or not known)"))
TROW	ConnectionError: HTTPSConnectionPool(host='stooq.com', port=443): Max retries exceeded with url: /q/d/l/?s=trow.us&i=d (Caused by NameResolutionError("HTTPSConnection(host='stooq.com', port=443): Failed to resolve 'stooq.com' ([Errno 8] nodename nor servname provided, or not known)"))
TTWO	ConnectionError: HTTPSConnectionPool(host='stooq.com', port=443): Max retries exceeded with url: /q/d/l/?s=ttwo.us&i=d (Caused by NameResolutionError("HTTPSConnection(host='stooq.com', port=443): Failed to resolve 'stooq.com' ([Errno 8] nodename nor servname provided, or not known)"))
TPR	ConnectionError: HTTPSConnectionPool(host='stooq.com', port=443): Max retries exceeded with url: /q/d/l/?s=tpr.us&i=d (Caused by NameResolutionError("HTTPSConnection(host='stooq.com', port=443): Failed to resolve 'stooq.com' ([Errno 8] nodename nor servname provided, or not known)"))
TRGP	ConnectionError: HTTPSConnectionPool(host='stooq.com', port=443): Max retries exceeded with url: /q/d/l/?s=trgp.us&i=d (Caused by NameResolutionError("HTTPSConnection(host='stooq.com', port=443): Failed to resolve 'stooq.com' ([Errno 8] nodename nor servname provided, or not known)"))
TGT	ConnectionError: HTTPSConnectionPool(host='stooq.com', port=443): Max retries exceeded with url: /q/d/l/?s=tgt.us&i=d (Caused by NameResolutionError("HTTPSConnection(host='stooq.com', port=443): Failed to resolve 'stooq.com' ([Errno 8] nodename nor servname provided, or not known)"))
TEL	ConnectionError: HTTPSConnectionPool(host='stooq.com', port=443): Max retries exceeded with url: /q/d/l/?s=tel.us&i=d (Caused by NameResolutionError("HTTPSConnection(host='stooq.com', port=443): Failed to resolve 'stooq.com' ([Errno 8] nodename nor servname provided, or not known)"))
TDY	ConnectionError: HTTPSConnectionPool(host='stooq.com', port=443): Max retries exceeded with url: /q/d/l/?s=tdy.us&i=d (Caused by NameResolutionError("HTTPSConnection(host='stooq.com', port=443): Failed to resolve 'stooq.com' ([Errno 8] nodename nor servname provided, or not known)"))
TER	ConnectionError: HTTPSConnectionPool(host='stooq.com', port=443): Max retries exceeded with url: /q/d/l/?s=ter.us&i=d (Caused by NameResolutionError("HTTPSConnection(host='stooq.com', port=443): Failed to resolve 'stooq.com' ([Errno 8] nodename nor servname provided, or not known)"))
TSLA	ConnectionError: HTTPSConnectionPool(host='stooq.com', port=443): Max retries exceeded with url: /q/d/l/?s=tsla.us&i=d (Caused by NameResolutionError("HTTPSConnection(host='stooq.com', port=443): Failed to resolve 'stooq.com' ([Errno 8] nodename nor servname provided, or not known)"))
TXN	ConnectionError: HTTPSConnectionPool(host='stooq.com', port=443): Max retries exceeded with url: /q/d/l/?s=txn.us&i=d (Caused by NameResolutionError("HTTPSConnection(host='stooq.com', port=443): Failed to resolve 'stooq.com' ([Errno 8] nodename nor servname provided, or not known)"))
TPL	ConnectionError: HTTPSConnectionPool(host='stooq.com', port=443): Max retries exceeded with url: /q/d/l/?s=tpl.us&i=d (Caused by NameResolutionError("HTTPSConnection(host='stooq.com', port=443): Failed to resolve 'stooq.com' ([Errno 8] nodename nor servname provided, or not known)"))
TXT	ConnectionError: HTTPSConnectionPool(host='stooq.com', port=443): Max retries exceeded with url: /q/d/l/?s=txt.us&i=d (Caused by NameResolutionError("HTTPSConnection(host='stooq.com', port=443): Failed to resolve 'stooq.com' ([Errno 8] nodename nor servname provided, or not known)"))
TMO	ConnectionError: HTTPSConnectionPool(host='stooq.com', port=443): Max retries exceeded with url: /q/d/l/?s=tmo.us&i=d (Caused by NameResolutionError("HTTPSConnection(host='stooq.com', port=443): Failed to resolve 'stooq.com' ([Errno 8] nodename nor servname provided, or not known)"))
TJX	ConnectionError: HTTPSConnectionPool(host='stooq.com', port=443): Max retries exceeded with url: /q/d/l/?s=tjx.us&i=d (Caused by NameResolutionError("HTTPSConnection(host='stooq.com', port=443): Failed to resolve 'stooq.com' ([Errno 8] nodename nor servname provided, or not known)"))
TKO	ConnectionError: HTTPSConnectionPool(host='stooq.com', port=443): Max retries exceeded with url: /q/d/l/?s=tko.us&i=d (Caused by NameResolutionError("HTTPSConnection(host='stooq.com', port=443): Failed to resolve 'stooq.com' ([Errno 8] nodename nor servname provided, or not known)"))
TTD	ConnectionError: HTTPSConnectionPool(host='stooq.com', port=443): Max retries exceeded with url: /q/d/l/?s=ttd.us&i=d (Caused by NameResolutionError("HTTPSConnection(host='stooq.com', port=443): Failed to resolve 'stooq.com' ([Errno 8] nodename nor servname provided, or not known)"))
TSCO	ConnectionError: HTTPSConnectionPool(host='stooq.com', port=443): Max retries exceeded with url: /q/d/l/?s=tsco.us&i=d (Caused by NameResolutionError("HTTPSConnection(host='stooq.com', port=443): Failed to resolve 'stooq.com' ([Errno 8] nodename nor servname provided, or not known)"))
TT	ConnectionError: HTTPSConnectionPool(host='stooq.com', port=443): Max retries exceeded with url: /q/d/l/?s=tt.us&i=d (Caused by NameResolutionError("HTTPSConnection(host='stooq.com', port=443): Failed to resolve 'stooq.com' ([Errno 8] nodename nor servname provided, or not known)"))
TDG	ConnectionError: HTTPSConnectionPool(host='stooq.com', port=443): Max retries exceeded with url: /q/d/l/?s=tdg.us&i=d (Caused by NameResolutionError("HTTPSConnection(host='stooq.com', port=443): Failed to resolve 'stooq.com' ([Errno 8] nodename nor servname provided, or not known)"))
TRV	ConnectionError: HTTPSConnectionPool(host='stooq.com', port=443): Max retries exceeded with url: /q/d/l/?s=trv.us&i=d (Caused by NameResolutionError("HTTPSConnection(host='stooq.com', port=443): Failed to resolve 'stooq.com' ([Errno 8] nodename nor servname provided, or not known)"))
TRMB	ConnectionError: HTTPSConnectionPool(host='stooq.com', port=443): Max retries exceeded with url: /q/d/l/?s=trmb.us&i=d (Caused by NameResolutionError("HTTPSConnection(host='stooq.com', port=443): Failed to resolve 'stooq.com' ([Errno 8] nodename nor servname provided, or not known)"))
TFC	ConnectionError: HTTPSConnectionPool(host='stooq.com', port=443): Max retries exceeded with url: /q/d/l/?s=tfc.us&i=d (Caused by NameResolutionError("HTTPSConnection(host='stooq.com', port=443): Failed to resolve 'stooq.com' ([Errno 8] nodename nor servname provided, or not known)"))
TYL	ConnectionError: HTTPSConnectionPool(host='stooq.com', port=443): Max retries exceeded with url: /q/d/l/?s=tyl.us&i=d (Caused by NameResolutionError("HTTPSConnection(host='stooq.com', port=443): Failed to resolve 'stooq.com' ([Errno 8] nodename nor servname provided, or not known)"))
TSN	ConnectionError: HTTPSConnectionPool(host='stooq.com', port=443): Max retries exceeded with url: /q/d/l/?s=tsn.us&i=d (Caused by NameResolutionError("HTTPSConnection(host='stooq.com', port=443): Failed to resolve 'stooq.com' ([Errno 8] nodename nor servname provided, or not known)"))
USB	ConnectionError: HTTPSConnectionPool(host='stooq.com', port=443): Max retries exceeded with url: /q/d/l/?s=usb.us&i=d (Caused by NameResolutionError("HTTPSConnection(host='stooq.com', port=443): Failed to resolve 'stooq.com' ([Errno 8] nodename nor servname provided, or not known)"))
UBER	ConnectionError: HTTPSConnectionPool(host='stooq.com', port=443): Max retries exceeded with url: /q/d/l/?s=uber.us&i=d (Caused by NameResolutionError("HTTPSConnection(host='stooq.com', port=443): Failed to resolve 'stooq.com' ([Errno 8] nodename nor servname provided, or not known)"))
UDR	ConnectionError: HTTPSConnectionPool(host='stooq.com', port=443): Max retries exceeded with url: /q/d/l/?s=udr.us&i=d (Caused by NameResolutionError("HTTPSConnection(host='stooq.com', port=443): Failed to resolve 'stooq.com' ([Errno 8] nodename nor servname provided, or not known)"))
ULTA	ConnectionError: HTTPSConnectionPool(host='stooq.com', port=443): Max retries exceeded with url: /q/d/l/?s=ulta.us&i=d (Caused by NameResolutionError("HTTPSConnection(host='stooq.com', port=443): Failed to resolve 'stooq.com' ([Errno 8] nodename nor servname provided, or not known)"))
UNP	ConnectionError: HTTPSConnectionPool(host='stooq.com', port=443): Max retries exceeded with url: /q/d/l/?s=unp.us&i=d (Caused by NameResolutionError("HTTPSConnection(host='stooq.com', port=443): Failed to resolve 'stooq.com' ([Errno 8] nodename nor servname provided, or not known)"))
UAL	ConnectionError: HTTPSConnectionPool(host='stooq.com', port=443): Max retries exceeded with url: /q/d/l/?s=ual.us&i=d (Caused by NameResolutionError("HTTPSConnection(host='stooq.com', port=443): Failed to resolve 'stooq.com' ([Errno 8] nodename nor servname provided, or not known)"))
UPS	ConnectionError: HTTPSConnectionPool(host='stooq.com', port=443): Max retries exceeded with url: /q/d/l/?s=ups.us&i=d (Caused by NameResolutionError("HTTPSConnection(host='stooq.com', port=443): Failed to resolve 'stooq.com' ([Errno 8] nodename nor servname provided, or not known)"))
URI	ConnectionError: HTTPSConnectionPool(host='stooq.com', port=443): Max retries exceeded with url: /q/d/l/?s=uri.us&i=d (Caused by NameResolutionError("HTTPSConnection(host='stooq.com', port=443): Failed to resolve 'stooq.com' ([Errno 8] nodename nor servname provided, or not known)"))
UNH	ConnectionError: HTTPSConnectionPool(host='stooq.com', port=443): Max retries exceeded with url: /q/d/l/?s=unh.us&i=d (Caused by NameResolutionError("HTTPSConnection(host='stooq.com', port=443): Failed to resolve 'stooq.com' ([Errno 8] nodename nor servname provided, or not known)"))
UHS	ConnectionError: HTTPSConnectionPool(host='stooq.com', port=443): Max retries exceeded with url: /q/d/l/?s=uhs.us&i=d (Caused by NameResolutionError("HTTPSConnection(host='stooq.com', port=443): Failed to resolve 'stooq.com' ([Errno 8] nodename nor servname provided, or not known)"))
VLO	ConnectionError: HTTPSConnectionPool(host='stooq.com', port=443): Max retries exceeded with url: /q/d/l/?s=vlo.us&i=d (Caused by NameResolutionError("HTTPSConnection(host='stooq.com', port=443): Failed to resolve 'stooq.com' ([Errno 8] nodename nor servname provided, or not known)"))
VTR	ConnectionError: HTTPSConnectionPool(host='stooq.com', port=443): Max retries exceeded with url: /q/d/l/?s=vtr.us&i=d (Caused by NameResolutionError("HTTPSConnection(host='stooq.com', port=443): Failed to resolve 'stooq.com' ([Errno 8] nodename nor servname provided, or not known)"))
VLTO	ConnectionError: HTTPSConnectionPool(host='stooq.com', port=443): Max retries exceeded with url: /q/d/l/?s=vlto.us&i=d (Caused by NameResolutionError("HTTPSConnection(host='stooq.com', port=443): Failed to resolve 'stooq.com' ([Errno 8] nodename nor servname provided, or not known)"))
VRSN	ConnectionError: HTTPSConnectionPool(host='stooq.com', port=443): Max retries exceeded with url: /q/d/l/?s=vrsn.us&i=d (Caused by NameResolutionError("HTTPSConnection(host='stooq.com', port=443): Failed to resolve 'stooq.com' ([Errno 8] nodename nor servname provided, or not known)"))
VRSK	ConnectionError: HTTPSConnectionPool(host='stooq.com', port=443): Max retries exceeded with url: /q/d/l/?s=vrsk.us&i=d (Caused by NameResolutionError("HTTPSConnection(host='stooq.com', port=443): Failed to resolve 'stooq.com' ([Errno 8] nodename nor servname provided, or not known)"))
VZ	ConnectionError: HTTPSConnectionPool(host='stooq.com', port=443): Max retries exceeded with url: /q/d/l/?s=vz.us&i=d (Caused by NameResolutionError("HTTPSConnection(host='stooq.com', port=443): Failed to resolve 'stooq.com' ([Errno 8] nodename nor servname provided, or not known)"))
VRTX	ConnectionError: HTTPSConnectionPool(host='stooq.com', port=443): Max retries exceeded with url: /q/d/l/?s=vrtx.us&i=d (Caused by NameResolutionError("HTTPSConnection(host='stooq.com', port=443): Failed to resolve 'stooq.com' ([Errno 8] nodename nor servname provided, or not known)"))
VTRS	ConnectionError: HTTPSConnectionPool(host='stooq.com', port=443): Max retries exceeded with url: /q/d/l/?s=vtrs.us&i=d (Caused by NameResolutionError("HTTPSConnection(host='stooq.com', port=443): Failed to resolve 'stooq.com' ([Errno 8] nodename nor servname provided, or not known)"))
VICI	ConnectionError: HTTPSConnectionPool(host='stooq.com', port=443): Max retries exceeded with url: /q/d/l/?s=vici.us&i=d (Caused by NameResolutionError("HTTPSConnection(host='stooq.com', port=443): Failed to resolve 'stooq.com' ([Errno 8] nodename nor servname provided, or not known)"))
V	ConnectionError: HTTPSConnectionPool(host='stooq.com', port=443): Max retries exceeded with url: /q/d/l/?s=v.us&i=d (Caused by NameResolutionError("HTTPSConnection(host='stooq.com', port=443): Failed to resolve 'stooq.com' ([Errno 8] nodename nor servname provided, or not known)"))
VST	ConnectionError: HTTPSConnectionPool(host='stooq.com', port=443): Max retries exceeded with url: /q/d/l/?s=vst.us&i=d (Caused by NameResolutionError("HTTPSConnection(host='stooq.com', port=443): Failed to resolve 'stooq.com' ([Errno 8] nodename nor servname provided, or not known)"))
VMC	ConnectionError: HTTPSConnectionPool(host='stooq.com', port=443): Max retries exceeded with url: /q/d/l/?s=vmc.us&i=d (Caused by NameResolutionError("HTTPSConnection(host='stooq.com', port=443): Failed to resolve 'stooq.com' ([Errno 8] nodename nor servname provided, or not known)"))
WRB	ConnectionError: HTTPSConnectionPool(host='stooq.com', port=443): Max retries exceeded with url: /q/d/l/?s=wrb.us&i=d (Caused by NameResolutionError("HTTPSConnection(host='stooq.com', port=443): Failed to resolve 'stooq.com' ([Errno 8] nodename nor servname provided, or not known)"))
GWW	ConnectionError: HTTPSConnectionPool(host='stooq.com', port=443): Max retries exceeded with url: /q/d/l/?s=gww.us&i=d (Caused by NameResolutionError("HTTPSConnection(host='stooq.com', port=443): Failed to resolve 'stooq.com' ([Errno 8] nodename nor servname provided, or not known)"))
WAB	ConnectionError: HTTPSConnectionPool(host='stooq.com', port=443): Max retries exceeded with url: /q/d/l/?s=wab.us&i=d (Caused by NameResolutionError("HTTPSConnection(host='stooq.com', port=443): Failed to resolve 'stooq.com' ([Errno 8] nodename nor servname provided, or not known)"))
WMT	ConnectionError: HTTPSConnectionPool(host='stooq.com', port=443): Max retries exceeded with url: /q/d/l/?s=wmt.us&i=d (Caused by NameResolutionError("HTTPSConnection(host='stooq.com', port=443): Failed to resolve 'stooq.com' ([Errno 8] nodename nor servname provided, or not known)"))
DIS	ConnectionError: HTTPSConnectionPool(host='stooq.com', port=443): Max retries exceeded with url: /q/d/l/?s=dis.us&i=d (Caused by NameResolutionError("HTTPSConnection(host='stooq.com', port=443): Failed to resolve 'stooq.com' ([Errno 8] nodename nor servname provided, or not known)"))
WBD	ConnectionError: HTTPSConnectionPool(host='stooq.com', port=443): Max retries exceeded with url: /q/d/l/?s=wbd.us&i=d (Caused by NameResolutionError("HTTPSConnection(host='stooq.com', port=443): Failed to resolve 'stooq.com' ([Errno 8] nodename nor servname provided, or not known)"))
WM	ConnectionError: HTTPSConnectionPool(host='stooq.com', port=443): Max retries exceeded with url: /q/d/l/?s=wm.us&i=d (Caused by NameResolutionError("HTTPSConnection(host='stooq.com', port=443): Failed to resolve 'stooq.com' ([Errno 8] nodename nor servname provided, or not known)"))
WAT	ConnectionError: HTTPSConnectionPool(host='stooq.com', port=443): Max retries exceeded with url: /q/d/l/?s=wat.us&i=d (Caused by NameResolutionError("HTTPSConnection(host='stooq.com', port=443): Failed to resolve 'stooq.com' ([Errno 8] nodename nor servname provided, or not known)"))
WEC	ConnectionError: HTTPSConnectionPool(host='stooq.com', port=443): Max retries exceeded with url: /q/d/l/?s=wec.us&i=d (Caused by NameResolutionError("HTTPSConnection(host='stooq.com', port=443): Failed to resolve 'stooq.com' ([Errno 8] nodename nor servname provided, or not known)"))
WFC	ConnectionError: HTTPSConnectionPool(host='stooq.com', port=443): Max retries exceeded with url: /q/d/l/?s=wfc.us&i=d (Caused by NameResolutionError("HTTPSConnection(host='stooq.com', port=443): Failed to resolve 'stooq.com' ([Errno 8] nodename nor servname provided, or not known)"))
WELL	ConnectionError: HTTPSConnectionPool(host='stooq.com', port=443): Max retries exceeded with url: /q/d/l/?s=well.us&i=d (Caused by NameResolutionError("HTTPSConnection(host='stooq.com', port=443): Failed to resolve 'stooq.com' ([Errno 8] nodename nor servname provided, or not known)"))
WST	ConnectionError: HTTPSConnectionPool(host='stooq.com', port=443): Max retries exceeded with url: /q/d/l/?s=wst.us&i=d (Caused by NameResolutionError("HTTPSConnection(host='stooq.com', port=443): Failed to resolve 'stooq.com' ([Errno 8] nodename nor servname provided, or not known)"))
WDC	ConnectionError: HTTPSConnectionPool(host='stooq.com', port=443): Max retries exceeded with url: /q/d/l/?s=wdc.us&i=d (Caused by NameResolutionError("HTTPSConnection(host='stooq.com', port=443): Failed to resolve 'stooq.com' ([Errno 8] nodename nor servname provided, or not known)"))
WY	ConnectionError: HTTPSConnectionPool(host='stooq.com', port=443): Max retries exceeded with url: /q/d/l/?s=wy.us&i=d (Caused by NameResolutionError("HTTPSConnection(host='stooq.com', port=443): Failed to resolve 'stooq.com' ([Errno 8] nodename nor servname provided, or not known)"))
WSM	ConnectionError: HTTPSConnectionPool(host='stooq.com', port=443): Max retries exceeded with url: /q/d/l/?s=wsm.us&i=d (Caused by NameResolutionError("HTTPSConnection(host='stooq.com', port=443): Failed to resolve 'stooq.com' ([Errno 8] nodename nor servname provided, or not known)"))
WMB	ConnectionError: HTTPSConnectionPool(host='stooq.com', port=443): Max retries exceeded with url: /q/d/l/?s=wmb.us&i=d (Caused by NameResolutionError("HTTPSConnection(host='stooq.com', port=443): Failed to resolve 'stooq.com' ([Errno 8] nodename nor servname provided, or not known)"))
WTW	ConnectionError: HTTPSConnectionPool(host='stooq.com', port=443): Max retries exceeded with url: /q/d/l/?s=wtw.us&i=d (Caused by NameResolutionError("HTTPSConnection(host='stooq.com', port=443): Failed to resolve 'stooq.com' ([Errno 8] nodename nor servname provided, or not known)"))
WDAY	ConnectionError: HTTPSConnectionPool(host='stooq.com', port=443): Max retries exceeded with url: /q/d/l/?s=wday.us&i=d (Caused by NameResolutionError("HTTPSConnection(host='stooq.com', port=443): Failed to resolve 'stooq.com' ([Errno 8] nodename nor servname provided, or not known)"))
WYNN	ConnectionError: HTTPSConnectionPool(host='stooq.com', port=443): Max retries exceeded with url: /q/d/l/?s=wynn.us&i=d (Caused by NameResolutionError("HTTPSConnection(host='stooq.com', port=443): Failed to resolve 'stooq.com' ([Errno 8] nodename nor servname provided, or not known)"))
XEL	ConnectionError: HTTPSConnectionPool(host='stooq.com', port=443): Max retries exceeded with url: /q/d/l/?s=xel.us&i=d (Caused by NameResolutionError("HTTPSConnection(host='stooq.com', port=443): Failed to resolve 'stooq.com' ([Errno 8] nodename nor servname provided, or not known)"))
XYL	ConnectionError: HTTPSConnectionPool(host='stooq.com', port=443): Max retries exceeded with url: /q/d/l/?s=xyl.us&i=d (Caused by NameResolutionError("HTTPSConnection(host='stooq.com', port=443): Failed to resolve 'stooq.com' ([Errno 8] nodename nor servname provided, or not known)"))
YUM	ConnectionError: HTTPSConnectionPool(host='stooq.com', port=443): Max retries exceeded with url: /q/d/l/?s=yum.us&i=d (Caused by NameResolutionError("HTTPSConnection(host='stooq.com', port=443): Failed to resolve 'stooq.com' ([Errno 8] nodename nor servname provided, or not known)"))
ZBRA	ConnectionError: HTTPSConnectionPool(host='stooq.com', port=443): Max retries exceeded with url: /q/d/l/?s=zbra.us&i=d (Caused by NameResolutionError("HTTPSConnection(host='stooq.com', port=443): Failed to resolve 'stooq.com' ([Errno 8] nodename nor servname provided, or not known)"))
ZBH	ConnectionError: HTTPSConnectionPool(host='stooq.com', port=443): Max retries exceeded with url: /q/d/l/?s=zbh.us&i=d (Caused by NameResolutionError("HTTPSConnection(host='stooq.com', port=443): Failed to resolve 'stooq.com' ([Errno 8] nodename nor servname provided, or not known)"))
ZTS	ConnectionError: HTTPSConnectionPool(host='stooq.com', port=443): Max retries exceeded with url: /q/d/l/?s=zts.us&i=d (Caused by NameResolutionError("HTTPSConnection(host='stooq.com', port=443): Failed to resolve 'stooq.com' ([Errno 8] nodename nor servname provided, or not known)"))
